111111111111111111111111
1000000C00E0000000010111
0111111P1111111111110111
111111111111111111111111
