111111111111111111111111
1000000000E0000000000111
1111111P1111111111110111
100000000000000000000111
111111111111111111111111
