111111111111111111111111
1000P00C00E0000000010111
111111111111111111110111
111111111111111111111111
