111111111111111111111111
1000000C00E0000000010111
1111111P1111111111110111
111101111111111111111111
