111111111111111111111111
1000000C0000000000000111
1111111P1111111111110111
1000000C0000000000000111
111111111111111111111111
