111111111111111111111111
1000P00C00E000000001011
111111111111111111110111
111111111111111111111111
