11111111111111111111111111111111111111111111111111111111111
1P0000000000000000000000000000000000000000000000000000000C1
11111111111111111111111111111011111111111111111111111111111
1H000000000000000000000000000000000000000000000000000000001
111111111111111111111111111CCC11111111111111111111111111111
10000000000000000000000000000000000000000000000000000000001
11111111CC1111111111111111111111111111111111111111111111111
10000000000000000000000000000000000000000000000000000000001
1C111111111111111111111111111111111111111111111111111111111
10000000000000000000000000000000000000000000000000000000001
11111111111111111111111C11111111111111111111111111111111111
10000000000000000000000000000000000000000000000000000000001
1111111111C111111111111111111111111111111111111111111111111
10000000000000000000000000000000000000000000000000000000001
111111111C1111111111111111111111111111111111111111111111111
10000000000000000000000000000000000000000000000000000000001
11111111111111111111111111111C1111111111111C111111111111111
10000000000000000000000000000000000000000000000000000000001
1111111111111111111111111111111111111111111C111111111111111
10000000000000000000000000000000000000000000000000000000001
1111111111111C111111111111111111111111111111111111111111111
100000000000000000000000000000C000C000000000000000000000001
111111111111C1111111111111111111111111111111111111111111111
10000000000000000000000000000000000000000000000000000000001
111111111111111111111111111111111111111111111111111C1111111
10000000000000000000000000000000000000000000000000000000001
11111111111111111111111111111111111C11111111111111111111111
1C0000000000000000000000000000000000000000000000000C00000C1
11111111111111111111111111111C11111111111111111111111111111
1E0000000000000000000000000000000000000000000000000000000C1
11111111111111111111111111111111111111111111111111111111111
