111111111111111111111111
1000000C00E0000000010111
1111111P111111111111H111
111111111111111111111111
